111111111111111111111111111111111111111111111111111111111111
1P1E00000000000000000000000000000000000000000000000000000001
101111111111100000000011111111111000000000111111111111111101
10100000000010000000001000000000000000000010000000C000000101
101000000000101000000010111111111111111000100000000000000101
101000000000101000000010000000000100000000100000000000000101
101000000000101000000000100000011100000001100000000000000101
101000000000101111110000100000000000000001110000000000000101
101000000000100000000000111111111100000001111111111111111101
101111111111111111111100100000000100000001010000001000000001
100000010000000000000000010100010100000001010100101000000001
100000010000000001111111010101111100000001000100101000000001
100000010000000000000000010000000000000000000111111110000001
101111010000000000000000011111111111000000000000000000000001
101001010000000C00000000010000000010000001000000000000000001
101001010000000000000000010000000010000001011111000000000001
101001010000000000000000000111111110000001000000000000000001
100001000000000000000000000000000000000001010000000000000001
100001111111111111000000000000000011111111010000000000000001
100000000000C01000011111111111110000000000011111110000000001
100000111111101000010000000000010000000000010000000000000001
100000100000001000010000000000010100000000010000000000000001
100000100000001000010000000000010100000000000000000000000001
101111111111111110011111111111110101111011111111111111111101
101000000000000010000000000000000101000010000000000000000101
101000000000000010111111111110011101001010000000000000000101
101000000000000010100000000000010001001010000000000000000101
101000000000000010100111111111110001001010000000000000000101
101000000000000010000100000000000000001010000000000000000101
101111111111111110111110001111100000001011111111111111111101
100000000000C000000000000000100000000000000000000000000000C1
111111111111111111111111111111111111111111111111111111111111
