1111111111111111111111111111111111
1000000000000000100000000000000001
10P00000000000001000000000C0000001
1000000000000000100000000000000001
1CCCCCC000000000100000000000000001
1000000000000000100000000000000001
10000000000000001C0000000000000001
10000000000000001C0000000000000001
100000000C000000000000000000000001

1000000000000000000000000000000001
1111111111111110001111111111111111
1000000000000000000000000000000001
1000000000000001000C00000000000001
1000000000000001000000000000000001
100C000000000001000000000000000001
10000000000000010000000000000C0001
1000000000000001000000000000000001
1000000C00000001000000000000000E01
1C00000000000001000000000000000001
1111111111111111111111111111111111