111111
10CCE1
1P0001
111111