1111111111111111111111111111111111111111111111111111
1000000000000000000000000000000000000000000000000001
1011111111110111111111110111111111111111111111110001
101CCCCCCCC00000000000010100000000000000000000000101
1010000000000000000000010100000000000000000000000101
10100000000000000000000101000000CCCCCCCCCCCC00000101
10100000000000000000000101000000CCCCCCCCCCCC00000101
1010000000C000000000000101CCCCCCC0000000000000000101
1010000000000000000000010100000000000000000000000101
1010000000000000000000010100000000000000000000000101
10000000CC000000000000010100000000000000000000000001
1010111111111111111111000001111111111111111111110101
1P00000000000000000000000000000000000000000000000001
1010111111111111111111000001111111111111111111110101
100C000000000000000000C101CCCCCCCCCCCCCCCCCCCCCCC001
10100000000000000000000101CCCCCCCCCCCCCCCCCCCCCCC101
10100000000000000000000101CCCCCCCCCCCCCCCCCCCCCCC101
10100000000000000000000101CCCCCCCCCCCCCCCCCCCCCCC101
1010000000000000000000010100000000000000000000000001
101C000000000000000000C101CCCCCCCCCCCCCCCCCCCCCCC101
10100000000000000000000101CCCCCCCCCCCCCCCCCCCCCCC101
101000000000000000000001C1CCCCCCCCCCCCCCCCCCCCCCC101
10100000000000000000000101CCCCCCCCCCCCCCCCCCCCCCC101
101111111111011111111111C111111111111111111111111101
1000000000000000000000000000000000000000000000000001
1011111111111111111111111111111111111111111111111101
1E00000000000000000000000000000000000000000000000001
1111111111111111111111111111111111111111111111111111