1111111111111
10010000000C1
10000111110C1
1P001100CCCC1
1000CC0CC00C1
1000000000001
11111110C00C1
1000000000001
1E00CCC0000C1
1111111111111