1111111111111111111111111111111111111111111111111111
111111111111111111111111C111111111111111111111111111
111111111111111111111111C111111111111111111111111111
111111111111111111111111C111111111111111111111111111
111111111111111111111111C111111111111111111111111111
111111111111111111111111C111111111111111111111111111
111111111111111111111111C111111111111111111111111111
111111111111111111111111C111111111111111111111111111
111111111111111111111111C111111111111111111111111111
1EPCCCCCCCCCCCCCCCCCCCCCCCCCCCCCCCCCCCCCCCCCCCCCCCC1
111111111111111111111111C111111111111111111111111111
111111111111111111111111C111111111111111111111111111
111111111111111111111111C111111111111111111111111111
111111111111111111111111C111111111111111111111111111
111111111111111111111111C111111111111111111111111111
111111111111111111111111C111111111111111111111111111
111111111111111111111111C111111111111111111111111111
111111111111111111111111C111111111111111111111111111
111111111111111111111111C111111111111111111111111111
1111111111111111111111111111111111111111111111111111