11111
1E0C1
10001
1PC01
10001
11111