11111111111111111111111111111111
1CCCCCCCCCCCCCCCC1CCCCCCCCCCCCC1
1C11111111111111C1C11111111111C1
1C1CCCCCCCCCCCC1C1C1CCCCCCCCC1C1
1C1C1111111111C1C1C1C1111111C1C1
1C1C1CCCCCCCC1C1C1C1C1CCCCC1C1C1
1C1C1C111111C1C1C1C1C1C111C1C1C1
1C1C1C1CCCC1C1C1C1C1C1CCC1C1C1C1
1C1C1C1C11C1C1C1C1C1C111C1C1C1C1
1C1C1CCC1CC1C1C1C1C1CCC1C1C1C1C1
1C1C11111C11C1C1C1C111CCC1C1C1C1
1C1CCCCCCC1CC1C1C1CCC11111C1C1C1
1C111111111C11C1C111CCCCCCC1C1C1
1CCCCCCCCCCC1CC1CCC111111111C1C1
1111111111111C1111CCCCCCCCCCC1C1
1CCCCCCCCCCCCC1PC1111111111111C1
1C1111111111111CC1CCCCCCCCCCCCC1
1C1CCCCCCCCCCC11C1C1111111111111
1C1C111111111CC1C1C1CCCCCCCCCCC1
1C1C1CCCCCCC11C1C1C1C111111111C1
1C1C1C11111CC1C1C1C1C1CCCCCCC1C1
1C1C1C1CCC11C1C1C1C1C1C11111C1C1
1C1C1C1C1CC1C1C1C1C1C1C1CCC1C1C1
1C1C1C1C11C1C1C1C1C1C1C1C1C1C1C1
1C1C1C1CC1C1C1C1C1C1C1CCC1C1C1C1
1C1C1C11C1C1C1C1C1C1C11111C1C1C1
1C1C1CCCC1C1C1C1C1C1CCCCCCC1C1C1
1C1C111111C1C1C1C1C111111111C1C1
1C1CCCCCCCC1C1C1C1CCCCCCCCCCC1C1
1C1111111111C1C1C1111111111111C1
1CCCCCCCCCCCC1E1CCCCCCCCCCCCCCC1
11111111111111111111111111111111