1111111111111111111111111111111111
1E0000000000001C00000C000000000001
1011111111111110101001000000010101
1010010010101010001001000000010101
1P1000000C00C0000000000000000000C1
1111111111111111111111111111111111