1111111111111111111111111111111111
100000001000000C00000C0000000000E1
1001111111111110101001000000010101
1000010010101010001001000000010101
1P0000001C00C0000000000000000100C1
1111111111111111111111111111111111