1111111111111111111111111111111111
100000000000000C00000C0000000100E1
1011111111111110101001000000010101
1010010010101010001001000000010101
1P1000000C00C0000000000000000100C1
1111111111111111111111111111111111