11111111111111111111111111
1C0000000C00110000000C0001
1011110111101101111C111101
101111C11110110111101111C1
10111101111C11011110111101
1CCC0000000000000000000001
10111101011111111010111101
1000000100001100C010000001
11111101111011011110111111
11111101000000000010111111
11111101011100111010111111
10C000000100C00010000000C1
11111101011100111010111111
11111101000000000010111111
11111101010111111010111111
100000C0000011000000C00001
10111101111011011110111101
10C011C00C0000C00000110C01
11101101011111111010110111
1C0C00C10C0011C0001C00C001
101111111110110111111111C1
1EC000C000000P000000000001
11111111111111111111111111
11111111111111111111111111