11111111111111111111111111111111111
10000000010000000100000001000000001
1E110111010111110101111101011101101
10110111010111110101111101011101101
10000000000000000000000000000000001
10110101111101011111010111110101101
10000100010001000100010001000100001
111101C10101111101011111010101C1111
11110101000001000000010000010101111
11110101011101011011010111010101111
1000000001000001CCC1000001000000001
111101011101110111110111011101C1111
11110100000001000000010000000101111
11110101111101011111010111110101111
10000000010000000100000001000000001
10110111010111110101111101011101101
10010000000000000000000000000001001
11010101111101011111010111110101011
10000100010001000100010001000100001
10111111010111110101111101011111101
1P000000000000000000000000000000001
11111111111111111111111111111111111