111111111111111111111111111111111111111111111111111111111111111111111111111111111111111111111111111111111111111111111111111111111111111
1E0C1110000C0000010C1100C00000000000000000000000000000000000000000000000000000000000000000000000000000000000000000000000000000000000111
10000000C11000000010C1100C0000000000000000000000000000000000000000000000000000000000000000000000000000000000000000000000000000000000011
1P00000000000000001000000C0000000000000000000000000111111000000000000000C00000000000000000000000000000000000000000000000000000000000001
1001110C000000000010C1100C0000000000000000000000000000000000000000000000000000000000000000000000000000000000000000000000000000000000001
10000000000C000000010C0000C000000000000000000000000000000000000000000000000000000000000000000000000000000000000000000000000000000000011
100000010C0100000010C0000C000000000000000000C000000000000000000000000000000000000000000000000000000000000000000C00000000000000000000011
10010C1100C000000010C1100C0000000000000000000000000000000000000000000000000000000000000000000000000000000000000000000000000000000000001
1110000000000000000010010C1100C00000000000000000000000000000000000000000000000000000000000000000000000000000000000000000000000000000001
10000000000000000000000000000000000000000000000000000000000000000000000C000000000000000000000000000000000000000000000000000000000000001
100000000000000000000000000000000000000000000000000000000000000000000000000000000000000000000000000000000000000000C00000000000000000001
10000000000000000C000000000000000000000000000000000C00000000000000000000000000000000000000000000000000000000000000000000000000000000001
100000000000000000000000000000000000000000000000000000000000000000000000000000000000000000000000000000000000000000000000000000000000001
10000000000000000000000000000000C000000000000000000000000000000001100000000000000000000000000000000000000000000000C00000000000000000001
1000000000000000000000000000000000000000000000000000000000000000000000000000000000000000000000000000000000000C0000000000000000000000001
10000000000000100000000000000000000000000000000000000000000000000000000C000000000000000000000000000000000000000000000000000000000000001
100000000000000000000000000000000000000000000000000000000000000000000000000000000000000000000001000000000000000000000000000000000000001
100000000000000000000000000000000000000000000000000000000000000000000000000000000000000000000000000000000000000000000000000000000000001
1000000000000000C000000000000000000000000000000000C0000000000000000000000000000000000000000000000000000000000000C0000000000000000000001
100000000000000000000000000000000000000000000000000000000000000000000000000000000000000000000110000000000000000000000000000000000000001
10000000000000000000000000000000000000000000000000000000000000011000000000000000C000000000000000000000000000000000000000000000000000001
100000000000000000000000CC0000000000000000000000000000000000000000000000000000000000000000000000000000000000000000000000000000000000001
100000000000000010000000000000000000000000000000000000000000000000000000000000000000000000000000000000000000111000000000000000000000001
111111111111111111111111111111111111111111111111111111111111111111111111111111111111111111111111111111111111111111111111111111111111111
